19 60
############################################################
  >                    **                                   
         #####################################              
                                             #              
         ################################### #          @   
          ################################## #              
          #                                # #              
    *     # ######################         # #              
    *     # # $$$$$$$$$$$$$$$$$$$$$$$$$$$$ # #       *      
          # # **************************** # #       *      
          # # $$$$$$$$$$$$$$$$$$$$$$$$$$$$ # #              
          # # **************************** # #              
          # #@  $$$$$$$$$$$$$$$$$$$$$$$$$$ # #              
          # #                              # #              
          # ################################ #              
          #                                  #              
          ####################################              
                                  **                        
############################################################