20 30
##############################
#                            #
#                            #
#                            #
#                            #
#            *               #
#            *               #
#                            #
#           *                #
#          > *               #
#                            #
#                            #
#                            #
#                            #
#                            #
#                            #
#                            #
#                            #
#                            #
##############################