21 51
# # # # # # # # # # # # # # # # # # # # # # # # # #
                          $                        
#                                                 #
           $@                                      
#                                                 #
                                                   
#                                   *             #
     $                                             
#                                                 #
                      >                            
#                                                 #
                                                   
#                                                 #
                                                   
#                                    $            #
         *                                         
#                            @$                   #
                                                   
#                                                 #
 $                                                 
# # #$# # # # # # # # # # # # # # # # # # # # # # #